🍀🍀🍀🍀🍀🐱🍀🍀🍀🍀
🍀🍀🍀🍀🍀🧊🍀🍀🍀🍀
🍀🍀🍀🍀🍀💗🍀🍀🍀🍀
🍀🍀🍀🍀🍀🧊🍀🍀🍀🍀
🍀🍀🍀🍀🍀💗🍀🍀🍀🍀
🧊🍀🍀🍀🍀🍀🍀🍀🍀🍀
🍀🍀🍀🍀🍀🍀🍀🍀🍀🍀
🍀🍀🍀🍀🍀🍀🍀🍀🍀🍀
🍀🍀🍀🍀🍀🍀🍀🍀🍀🍀
🍀🍀🍀🍀🐶🍀🍀🍀🍀🍀
